111111111111111111111111111111111111111111111111111
222222222222222222222222222222222222222222222222222
222222222222222222222222222222222222222222222222222
222222222222222222222222222222222222222222222222222
222222222222222222222222222222222222222222222222222
222222222222222222222222222222222222222222222222222
222222222222222222222222222222222222222222222222222
222222222222222222222222222222222222222222222222222
222222222222222222222222222222222222222222222222222
222222222222222222222222222222222222222222222222222
222222222222222222222222222222222222222222222222222
222222222222222222222222222222222222222222222222222
222222222222222222222222222222222222222222222222222
222222222222222222222222222222222222222222222222222
222222222222222222222222222222222222222222222222222
222222222222222222222222222222222222222222222222222
222222222222222222222222222222222222222222222222222
222222222222222222222222222222222222222222222222222
222222222222222222222222222222222222222222222222222
222222222222222222222222222222222222111111122222222
222222222222222222222222222222222222100000122222222
222222222222222222222222222222222222100000122222222
222222222222222222222222222222222222100100122222222
222222222222222222222222222222222222100100122222222
222222222222222222222222222222222222100100122222222
222222222222222222222222222222222222100100122222222
222222222222222222222222222222222222100100122222222
222222222222222222222222222222222222100100122222222
222222222222222222222222222222222222100100122222222
222222222222222222222222222222222222100100122222222
222222222222222222222222222222222222100100122222222
222222222222222222222222222222222222100100122222222
222222222222222222222222222222222222100100122222222
222222222222222222222222222222222222100100022222222
222222222222222222222222222222222222100100002222222
111111111111111111111111111111111111100111111111111
000000000000000000000000000000000000000000000000000
000000000000000000000000000000000000000000000000000
000000000000000000000000000000000000000000000000000
000000000000000000000000000000000000000000000000000
000000000000000000000000000000000000000000000000000
000000000000000000000000000000000000000000000000000
000000000000000000000000000000000000000000000000000
000000000000000000000000000000000000000000000000000
000000000000000000000000000000000000000000000000000
000000000000000000000000000000000000000000000000000
000000000000000000000000000000000000000000000000000
000000000000000000000000000000000000000000000000000
000000000000000000000000000000000000000000000000000
000000000000000000000000000000000000000000000000000
000000000000000000000000000000000000000000000000000
000000000000000000000000000000000000000000000000000
000000000000000000000000000000000000000000000000000
000000000000000000000000000000000000000000000000000
000000000000000000000000000000000000000000000000000
000000000000000000000000000000000000000000000000000
000000000000000000000000000000000000000000000000000
000000000000000000000000000000000000000000000000000
000000000000000000000000000000000000000000000000000
000000000000000000000000000000000000000000000000000
000000000000000000000000000000000000000000000000000
000000000000000000000000000000000000000000000000000
000000000000000000000000000000000000000000000000000
000000000000000000000000000000000000000000000000000
000000000000000000000000000000000000000000000000000
000000000000000000000000000000000000000000000000000
000000000000000000000000000000000000000000000000000
000000000000000000000000000000000000000000000000000
000000000000000000000000000000000000000000000000000
000000000000000000000000000000000000000000000000000